一	一
丁	丁
七	七
万	万
丈	丈
三	三
上	上
下	下
不	不
丐	丐
丑	丑
且	且
世	世
丘	丘
丙	丙
丢	丟丢
中	中
丰	丰
串	串
丸	丸
丹	丹
主	主
乃	乃迺
久	久
么	么
之	之
乍	乍
乎	乎
乏	乏
乒	乒
乓	乓
乖	乖
乘	乘
乙	乙
九	九
乞	乞
也	也
乳	乳
乾	乾
亂	亂乱
了	了
予	予
争	爭争
事	事
二	二
于	于
云	云
互	互
五	五
井	井
些	些
亞	亞亚
亡	亡
交	交
亥	亥
亦	亦
享	享
京	京
亭	亭
亮	亮
人	人
什	什
仁	仁
仆	仆
仇	仇
今	今
介	介
仍	仍
仔	仔
他	他
仗	仗
付	付
仙	仙
代	代
令	令
以	以
仰	仰
仲	仲
件	件
价	价
任	任
份	份
仿	仿倣
企	企
伊	伊
伍	伍
伏	伏
伐	伐
休	休
伙	伙
伯	伯
估	估
伴	伴
伶	伶
伸	伸
伺	伺
似	似
佃	佃
但	但
位	位
低	低
住	住
佑	佑祐
何	何
余	余
佛	佛彿
作	作
你	你妳
佩	佩珮
佳	佳
使	使
侄	侄姪
來	來来
侈	侈
例	例
侍	侍
侖	侖仑崙
供	供
依	依
侣	侶侣
侮	侮
侯	侯
侵	侵
便	便
促	促
俄	俄
俊	俊
俏	俏
俐	俐
俗	俗
俘	俘
保	保
俠	俠侠
信	信
修	修脩
俯	俯
俱	俱
俺	俺
倆	倆俩
倉	倉仓
個	個个
倍	倍
們	們们
倒	倒
倔	倔
倘	倘
候	候
倚	倚
借	借
倡	倡
倦	倦
倫	倫伦
值	值
假	假
偉	偉伟
偎	偎
偏	偏
做	做
停	停
健	健
側	側侧
偵	偵侦
偶	偶
偷	偷
傀	傀
傅	傅
傍	傍徬
傘	傘伞
備	備备
催	催
傭	傭佣
傲	傲
傳	傳传
債	債债
傷	傷伤
傻	傻
傾	傾倾
僅	僅仅
像	像
僑	僑侨
僚	僚
僞	僞伪偽
僥	僥侥
僧	僧
僵	僵殭
僻	僻
儀	儀仪
億	億亿
儉	儉俭
儒	儒
償	償偿
儡	儡
優	優优
儲	儲储
允	允
元	元
兄	兄
充	充
兆	兆
先	先
光	光
克	克
免	免
兑	兌兑
兒	兒儿
兔	兔
党	党
兜	兜
兢	兢
入	入
全	全
兩	兩两
八	八
公	公
六	六
共	共
兵	兵
其	其
具	具
典	典
兼	兼
冀	冀
内	內内
册	冊册
再	再
冒	冒
冕	冕
冗	冗
冠	冠
冤	冤
冬	冬
冰	冰
冲	冲沖
决	決决
况	況况
冶	冶
冷	冷
净	淨净凈
凄	悽凄淒
准	准
凉	涼凉
凌	凌淩
凍	凍冻
减	減减
凑	湊凑
凛	凜凛
凝	凝
几	几
凡	凡
凭	凭
凰	凰
凱	凱凯
凳	凳
凶	凶兇
凸	凸
凹	凹
出	出
函	函
刀	刀
刁	刁
刃	刃
分	分
切	切
刊	刊
刑	刑
划	划
列	列
初	初
删	刪删
判	判
刨	刨鉋
利	利
别	別别
刮	刮
到	到
制	制
刷	刷
券	券
刹	剎刹
刺	刺
刻	刻
剃	剃
則	則则
削	削
前	前
剔	剔
剖	剖
剛	剛刚
剥	剝剥
剩	剩
剪	剪
副	副
割	割
創	創创
剿	剿勦
劇	劇剧
劈	劈
劉	劉刘
劊	劊刽
劍	劍剑
劑	劑剂
力	力
功	功
加	加
劣	劣
助	助
努	努
劫	劫
勁	勁劲
勃	勃
勇	勇
勉	勉
勒	勒
動	動动
勘	勘
務	務务
勛	勛勋勳
勝	勝胜
勞	勞劳
募	募
勢	勢势
勤	勤
勵	勵励
勸	勸劝
勺	勺
勾	勾
勿	勿
匀	勻匀
包	包
匆	匆
匈	匈
匕	匕
化	化
北	北
匙	匙
匠	匠
匣	匣
匪	匪
匯	匯汇
匹	匹
匾	匾
匿	匿
區	區区
十	十
千	千
升	升昇
午	午
半	半
卑	卑
卒	卒
卓	卓
協	協协
南	南
博	博
卜	卜
占	占佔
卡	卡
卦	卦
卧	臥卧
印	印
危	危
即	即
却	卻却
卵	卵
卷	卷
卸	卸
卿	卿
厂	厂
厘	厘釐
厚	厚
原	原
厠	厠厕廁
厢	廂厢
厦	廈厦
厨	廚厨
厭	厭厌
厲	厲厉
去	去
叁	叄叁
參	參参蔘
又	又
叉	叉
及	及
友	友
反	反
叔	叔
取	取
受	受
叙	敘叙
叛	叛
叠	疊叠
叢	叢丛
口	口
古	古
句	句
另	另
叨	叨
只	只
叫	叫
召	召
叭	叭
叮	叮
可	可
台	台
史	史
右	右
叶	叶
司	司
叼	叼
吁	吁
吃	吃
各	各
吆	吆
合	合
吉	吉
吊	吊弔
同	同
名	名
后	后
吏	吏
吐	吐
向	向
吕	呂吕
君	君
吝	吝
吞	吞
吟	吟
吠	吠
否	否
吧	吧
吩	吩
含	含
吭	吭
吮	吮
吱	吱
吴	吳吴
吵	吵
吸	吸
吹	吹
吻	吻
吼	吼
呀	呀
呆	呆
呈	呈
告	告
呐	吶呐
呢	呢
周	周週
味	味
呵	呵
呻	呻
呼	呼
命	命
咆	咆
和	和
咏	詠咏
咐	咐
咒	咒
咕	咕
咖	咖
咧	咧
咨	咨
咪	咪
咬	咬
咱	咱偺
咳	咳
咸	咸
咽	咽嚥
哀	哀
品	品
哄	哄閧鬨
哆	哆
哈	哈
哎	哎
員	員员
哥	哥
哨	哨
哩	哩
哪	哪
哭	哭
哮	哮
哲	哲
哺	哺
哼	哼
唁	唁
唆	唆
唇	唇脣
唉	唉
唐	唐
唤	喚唤
唧	唧
唬	唬
售	售
唯	唯
唱	唱
唾	唾
啃	啃
啄	啄
商	商
啊	啊
問	問问
啓	啓启啟
啞	啞哑
啡	啡
啤	啤
啥	啥
啦	啦
啼	啼
喂	喂餵
善	善
喇	喇
喉	喉
喊	喊
喘	喘
喜	喜
喝	喝
喧	喧
喪	喪丧
喬	喬乔
單	單单
喲	喲哟
喳	喳
喻	喻
嗅	嗅
嗆	嗆呛
嗎	嗎吗
嗓	嗓
嗚	嗚呜
嗜	嗜
嗡	嗡
嗤	嗤
嗦	嗦
嗽	嗽
嘀	嘀
嘁	嘁
嘆	嘆叹歎
嘉	嘉
嘔	嘔呕
嘗	嘗嚐尝
嘩	嘩哗譁
嘮	嘮唠
嘯	嘯啸
嘰	嘰叽
嘲	嘲
嘴	嘴
嘶	嘶
嘹	嘹
嘿	嘿
器	器
噩	噩
噪	噪
噴	噴喷
噸	噸吨
嚇	嚇吓
嚎	嚎
嚨	嚨咙
嚴	嚴严
嚷	嚷
嚼	嚼
囂	囂嚣
囉	囉啰
囊	囊
囑	囑嘱
囚	囚
四	四
回	回
因	因
囤	囤
困	困
囱	囪囱
固	固
圃	圃
圈	圈
國	國国
圍	圍围
園	園园
圓	圓圆
圖	圖图
團	團团
土	土
在	在
地	地
圾	圾
址	址
均	均
坊	坊
坎	坎
坐	坐
坑	坑
坡	坡
坤	坤
坦	坦
坪	坪
坯	坯
坷	坷
垂	垂
垃	垃
型	型
垛	垛
垢	垢
垮	垮
埂	埂
埃	埃
埋	埋
城	城
域	域
埠	埠
執	執执
培	培
基	基
堂	堂
堅	堅坚
堆	堆
堡	堡
堤	堤
堪	堪
堰	堰
報	報报
場	場场
堵	堵
塊	塊块
塌	塌
塑	塑
塔	塔
塘	塘
塞	塞
塢	塢坞
填	填
塵	塵尘
境	境
墅	墅
墊	墊垫
墓	墓
墜	墜坠
增	增
墨	墨
墩	墩
墮	墮堕
墳	墳坟
墻	牆墙墻
墾	墾垦
壁	壁
壇	壇坛
壓	壓压
壕	壕
壘	壘垒
壞	壞坏
壟	壟垄
壤	壤
壩	壩坝
士	士
壯	壯壮
壹	壹
壺	壺壶
壽	壽寿
夏	夏
夕	夕
外	外
多	多
夜	夜
够	夠够
夢	夢梦
大	大
天	天
太	太
夫	夫伕
夭	夭
央	央
夯	夯
失	失
夷	夷
夸	夸
夾	夾夹
奄	奄
奇	奇
奈	奈
奉	奉
奏	奏
契	契
奔	奔
奕	奕
套	套
奠	奠
奢	奢
奥	奧奥
奪	奪夺
奬	獎奖奬
奮	奮奋
女	女
奴	奴
奶	奶
奸	奸姦
她	她
好	好
如	如
妄	妄
妒	妒
妓	妓
妖	妖
妙	妙
妝	妝妆
妥	妥
妨	妨
妹	妹
妻	妻
姆	姆
姊	姊
始	始
姐	姐
姑	姑
姓	姓
委	委
姚	姚
姜	姜
姥	姥
姨	姨
姻	姻
姿	姿
威	威
娃	娃
娘	娘孃
娜	娜
娩	娩
娱	娛娱
娶	娶
婁	婁娄
婆	婆
婉	婉
婚	婚
婦	婦妇
婿	婿
媒	媒
媚	媚
媳	媳
媽	媽妈
嫁	嫁
嫂	嫂
嫉	嫉
嫌	嫌
嫡	嫡
嫩	嫩
嬉	嬉
嬌	嬌娇
嬰	嬰婴
嬸	嬸婶
子	子
孔	孔
孕	孕
字	字
存	存
孝	孝
孟	孟
季	季
孤	孤
孩	孩
孫	孫孙
孵	孵
學	學学
孽	孽
它	它牠
宅	宅
宇	宇
守	守
安	安
宋	宋
完	完
宏	宏
宗	宗
官	官
宙	宙
定	定
宛	宛
宜	宜
客	客
宣	宣
室	室
宦	宦
宫	宫宮
宰	宰
害	害
宴	宴
宵	宵
家	家
容	容
宿	宿
寂	寂
寄	寄
密	密
寇	寇
富	富
寒	寒
寓	寓
寞	寞
察	察
寡	寡
寢	寢寝
寥	寥
實	實实
寧	寧宁
寨	寨
審	審审
寫	寫写
寬	寬宽
寵	寵宠
寶	寶宝
寸	寸
寺	寺
封	封
射	射
將	將将
專	專专
尉	尉
尊	尊
尋	尋寻
對	對对
導	導导
小	小
少	少
尖	尖
尚	尚
尤	尤
就	就
尸	尸屍
尺	尺
尼	尼
尾	尾
尿	尿
局	局侷跼
屁	屁
居	居
屈	屈
屉	屜屉
届	屆届
屋	屋
屎	屎
屏	屏
屑	屑
展	展
屠	屠
屢	屢屡
層	層层
履	履
屬	屬属
屯	屯
山	山
屹	屹
岔	岔
岡	岡冈
岩	岩巖
岳	岳嶽
岸	岸
峭	峭
峰	峯峰
島	島岛
峻	峻
峽	峽峡
崇	崇
崎	崎
崔	崔
崖	崖
崗	崗岗
崩	崩
嵌	嵌
嶄	嶄崭
嶇	嶇岖
嶺	嶺岭
嶼	嶼屿
巍	巍
巒	巒峦
川	川
州	州
巡	巡
巢	巢
工	工
左	左
巧	巧
巨	巨
巫	巫
差	差
己	己
已	已
巴	巴
巷	巷
巾	巾
市	市
布	布佈
帆	帆
希	希
帕	帕
帖	帖
帘	帘
帚	帚
帝	帝
帥	帥帅
師	師师
席	席蓆
帳	帳帐
帶	帶带
常	常
帽	帽
幅	幅
幌	幌
幔	幔
幕	幕
幟	幟帜
幢	幢
幣	幣币
幫	幫帮
干	干
平	平
年	年
并	並併并
幸	幸倖
幻	幻
幼	幼
幽	幽
广	广
庇	庇
床	牀床
序	序
底	底
店	店
府	府
度	度
座	座
庫	庫库
庭	庭
庵	庵菴
庶	庶
康	康
庸	庸
廉	廉
廊	廊
廓	廓
廟	廟庙
廢	廢废
廬	廬庐
廳	廳厅
延	延
廷	廷
建	建
异	異异
弃	棄弃
弄	弄
弊	弊
式	式
弓	弓
引	引
弛	弛
弟	弟
弦	弦絃
弧	弧
弱	弱
張	張张
强	強强
彈	彈弹
彌	彌弥
彎	彎弯
形	形
彤	彤
彩	彩綵
彪	彪
彬	彬
彭	彭
彰	彰
影	影
役	役
彼	彼
往	往
征	征
待	待
很	很
徊	徊
律	律
徐	徐
徑	徑径
徒	徒
得	得
徘	徘
徙	徙
從	從从
御	御
復	復复
循	循
微	微
德	德
徹	徹彻
徽	徽
心	心
必	必
忌	忌
忍	忍
志	志誌
忘	忘
忙	忙
忠	忠
快	快
忱	忱
念	念唸
忽	忽
忿	忿
怎	怎
怒	怒
怔	怔
怕	怕
怖	怖
思	思
怠	怠
急	急
性	性
怨	怨
怪	怪
怯	怯
恃	恃
恍	恍
恐	恐
恒	恆恒
恕	恕
恢	恢
恤	恤卹
恨	恨
恩	恩
恬	恬
恭	恭
息	息
恰	恰
悄	悄
悉	悉
悍	悍
悔	悔
悟	悟
悠	悠
患	患
悦	悅悦
您	您
悲	悲
悴	悴
悶	悶闷
悼	悼
情	情
惋	惋
惑	惑
惕	惕
惜	惜
惠	惠
惡	惡恶
惦	惦
惰	惰
惱	惱恼
想	想
惶	惶
惹	惹
愁	愁
愈	愈瘉癒
愉	愉
意	意
愕	愕
愚	愚
愛	愛爱
感	感
愧	愧
愿	愿
慈	慈
態	態态
慌	慌
慎	慎
慕	慕
慘	慘惨
慚	慚惭
慢	慢
慣	慣惯
慧	慧
慨	慨
慮	慮虑
慰	慰
慶	慶庆
慷	慷
憂	憂忧
憊	憊惫
憋	憋
憎	憎
憐	憐怜
憔	憔
憤	憤愤
憨	憨
憫	憫悯
憲	憲宪
憶	憶忆
憾	憾
懂	懂
懇	懇恳
懈	懈
應	應应
懊	懊
懦	懦
懲	懲惩
懶	懶懒
懷	懷怀
懸	懸悬
懼	懼惧
戀	戀恋
戈	戈
成	成
我	我
戒	戒
或	或
戚	戚慼
截	截
戰	戰战
戲	戲戏
戳	戳
戴	戴
户	戶户
房	房
所	所
扁	扁
扇	扇
手	手
才	才
扎	扎紮
扑	扑
扒	扒
打	打
扔	扔
托	托託
扛	扛
扣	扣釦
扭	扭
扮	扮
扯	扯
扳	扳
扶	扶
批	批
扼	扼
找	找
承	承
技	技
抄	抄
把	把
抑	抑
抒	抒
抓	抓
投	投
抖	抖
抗	抗
折	折
抛	拋抛
披	披
抬	抬
抱	抱
抵	抵牴
抹	抹
押	押
抽	抽
拂	拂
拄	拄
拆	拆
拇	拇
拉	拉
拌	拌
拍	拍
拐	拐枴柺
拒	拒
拓	拓
拔	拔
拖	拖
拗	拗
拘	拘
拙	拙
招	招
拜	拜
括	括
拭	拭
拯	拯
拱	拱
拳	拳
拴	拴
拷	拷
拼	拼
拾	拾
拿	拿
持	持
挂	挂掛
指	指
按	按
挎	挎
挑	挑
挖	挖
挣	掙挣
挨	挨
挪	挪
挫	挫
振	振
挺	挺
挽	挽輓
挾	挾挟
捂	捂
捅	捅
捆	捆梱綑
捉	捉
捌	捌
捍	捍
捎	捎
捏	捏
捐	捐
捕	捕
换	換换
捧	捧
据	据
捶	捶
捷	捷
捺	捺
捻	捻撚
掀	掀
掂	掂
掃	掃扫
掄	掄抡
授	授
掉	掉
掌	掌
掏	掏
掐	掐
排	排
掖	掖
掘	掘
掠	掠
探	探
接	接
控	控
推	推
掩	掩
措	措
掰	掰
揀	揀拣
揉	揉
揍	揍
描	描
提	提
插	插
揖	揖
揚	揚扬颺飏
握	握
揣	揣
揩	揩
揪	揪
揭	揭
揮	揮挥
援	援
損	損损
搏	搏
搓	搓
搔	搔
搗	搗捣
搜	搜蒐
搞	搞
搪	搪
搬	搬
搭	搭
搶	搶抢
携	攜携
摇	搖摇
摔	摔
摘	摘
摟	摟搂
摧	摧
摩	摩
摯	摯挚
摳	摳抠
摸	摸
摹	摹
摻	摻掺
撇	撇
撈	撈捞
撑	撐撑
撒	撒
撓	撓挠
撕	撕
撞	撞
撣	撣掸
撤	撤
撥	撥拨
撩	撩
撫	撫抚
撬	撬
播	播
撮	撮
撰	撰
撼	撼
撿	撿捡
擁	擁拥
擂	擂
擅	擅
擇	擇择
擊	擊击
擋	擋挡
操	操
擎	擎
擒	擒
擔	擔担
擠	擠挤
擦	擦
擬	擬拟
擰	擰拧
擱	擱搁
擲	擲掷
擴	擴扩
擺	擺摆
擾	擾扰
攀	攀
攆	攆撵
攏	攏拢
攔	攔拦
攘	攘
攙	攙搀
攝	攝摄
攢	攢攒
攤	攤摊
攪	攪搅
攬	攬揽
支	支
收	收
改	改
攻	攻
放	放
政	政
故	故
效	效
敏	敏
救	救
敗	敗败
教	教
敞	敞
敢	敢
散	散
敦	敦
敬	敬
敲	敲
整	整
敵	敵敌
敷	敷
數	數数
斂	斂敛
斃	斃毙
文	文
斑	斑
斗	斗
料	料
斜	斜
斟	斟
斤	斤
斥	斥
斧	斧
斬	斬斩
斯	斯
新	新
斷	斷断
方	方
施	施
旁	旁
旅	旅
旋	旋
族	族
旗	旗
既	既
日	日
旦	旦
旨	旨
早	早
旬	旬
旭	旭
旱	旱
旺	旺
昂	昂
昆	昆崑
昌	昌
明	明
昏	昏
易	易
昔	昔
星	星
映	映
春	春
昧	昧
昨	昨
昭	昭
是	是
昵	暱昵
時	時时
晃	晃
晋	晉晋
晌	晌
晚	晚
晝	晝昼
晤	晤
晦	晦
晨	晨
普	普
景	景
晰	晰
晴	晴
晶	晶
智	智
晾	晾
暇	暇
暈	暈晕
暑	暑
暖	暖
暗	暗
暢	暢畅
暫	暫暂
暮	暮
暴	暴
曇	曇昙
曉	曉晓
曙	曙
曠	曠旷
曬	曬晒
曲	曲
更	更
書	書书
曹	曹
曼	曼
曾	曾
替	替
最	最
會	會会
月	月
有	有
朋	朋
服	服
朗	朗
望	望
朝	朝
期	期
朦	朦
朧	朧胧矓
木	木
未	未
末	末
本	本
术	术朮
朱	朱
朴	朴
朵	朵
朽	朽
杆	杆桿
杈	杈
杉	杉
李	李
杏	杏
材	材
村	村
杖	杖
杜	杜
束	束
杠	杠槓
杭	杭
杯	杯盃
杰	杰傑
東	東东
松	松
板	板
枉	枉
析	析
枕	枕
林	林
枚	枚
果	果
枝	枝
枯	枯
架	架
枷	枷
柄	柄
柏	柏
某	某
柑	柑
柒	柒
染	染
柔	柔
查	查
柬	柬
柱	柱
柳	柳
柴	柴
柿	柿
栅	柵栅
栓	栓
栖	棲栖
栗	栗慄
校	校
株	株
核	核
根	根
格	格
栽	栽
桂	桂
桃	桃
桅	桅
框	框
案	案
桌	桌
桐	桐
桑	桑
桶	桶
梁	梁樑
梅	梅
梆	梆
梗	梗
條	條条
梢	梢
梧	梧
梨	梨
梭	梭
梯	梯
械	械
梳	梳
棉	棉
棋	棋
棍	棍
棒	棒
棕	棕
棗	棗枣
棘	棘
棚	棚
棟	棟栋
棠	棠
棧	棧栈
森	森
棱	棱稜
棵	棵
棺	棺
椅	椅
植	植
椎	椎
椒	椒
椰	椰
椿	椿
楊	楊杨
楓	楓枫
楔	楔
楚	楚
楞	楞
楣	楣
業	業业
極	極极
楷	楷
概	概
榆	榆
榔	榔
榕	榕
榛	榛
榜	榜
榨	榨搾
榮	榮荣
榴	榴
構	構构
槍	槍枪
槐	槐
槳	槳桨
槽	槽
樁	樁桩
樂	樂乐
樊	樊
樓	樓楼
標	標标
樞	樞枢
樟	樟
模	模糢
樣	樣样
横	橫横
樹	樹树
樺	樺桦
橄	橄
橋	橋桥
橘	橘
橙	橙
機	機机
橡	橡
橢	橢椭
橱	櫥橱
檀	檀
檐	檐簷
檔	檔档
檢	檢检
檩	檁檩
檬	檬
檸	檸柠
櫃	櫃柜
櫻	櫻樱
欄	欄栏
權	權权
欖	欖榄
欠	欠
次	次
欣	欣
欲	欲慾
欺	欺
欽	欽钦
款	款
歇	歇
歉	歉
歌	歌
歐	歐欧
歡	歡欢
止	止
正	正
此	此
步	步
武	武
歧	歧
歪	歪
歲	歲岁
歷	歷历
歸	歸归
歹	歹
死	死
殃	殃
殉	殉
殊	殊
殖	殖
殘	殘残
殲	殲歼
段	段
殷	殷慇
殺	殺杀
殻	殼壳殻
殿	殿
毁	毀毁燬譭
毅	毅
毆	毆殴
母	母
每	每
毒	毒
比	比
毛	毛
毫	毫
毯	毯
氈	氈毡
氏	氏
民	民
氓	氓
氛	氛
氣	氣气
氧	氧
氨	氨
氫	氫氢
氮	氮
氯	氯
水	水
永	永
汁	汁
求	求
汗	汗
汛	汛
汞	汞
江	江
池	池
污	污汙
汪	汪
汰	汰
汹	洶汹
汽	汽
沃	沃
沈	沈
沉	沉
沐	沐
沙	沙
沛	沛
没	沒没
沫	沫
沮	沮
河	河
沸	沸
油	油
治	治
沼	沼
沽	沽
沾	沾霑
沿	沿
泄	泄
泉	泉
泊	泊
泌	泌
法	法
泛	泛氾
泡	泡
波	波
泣	泣
泥	泥
注	注註
泪	淚泪
泰	泰
泳	泳
泵	泵
洋	洋
洗	洗
洛	洛
洞	洞
津	津
洪	洪
洲	洲
活	活
洽	洽
派	派
流	流
浙	浙
浦	浦
浩	浩
浪	浪
浮	浮
浴	浴
海	海
浸	浸
涂	涂
消	消
涉	涉
涌	涌湧
涎	涎
涕	涕
涣	渙涣
涮	涮
涯	涯
液	液
涵	涵
淀	淀
淆	淆
淋	淋
淌	淌
淑	淑
淘	淘
淡	淡
淤	淤
淪	淪沦
淫	淫
淮	淮
深	深
淳	淳
淵	淵渊
混	混
淹	淹
淺	淺浅
添	添
清	清
渠	渠
渡	渡
渣	渣
渤	渤
渦	渦涡
温	溫温
測	測测
港	港
渴	渴
游	游遊
渺	渺
渾	渾浑
湃	湃
湖	湖
湘	湘
湯	湯汤
溉	溉
源	源
溜	溜
溝	溝沟
溢	溢
溪	溪谿
溯	溯
溶	溶
溺	溺
滄	滄沧
滅	滅灭
滋	滋
滌	滌涤
滑	滑
滓	滓
滔	滔
滚	滾滚
滬	滬沪
滯	滯滞
滲	滲渗
滴	滴
滿	滿满
漁	漁渔
漂	漂
漆	漆
漏	漏
演	演
漠	漠
漢	漢汉
漩	漩
漫	漫
漱	漱
漲	漲涨
漸	漸渐
漾	漾
漿	漿浆
潑	潑泼
潔	潔洁
潘	潘
潜	潛潜
潤	潤润
潦	潦
潭	潭
潮	潮
潰	潰溃
澀	澀涩
澄	澄
澆	澆浇
澇	澇涝
澈	澈
澎	澎
澗	澗涧
澡	澡
澤	澤泽
澳	澳
激	激
濁	濁浊
濃	濃浓
濕	濕湿溼
濘	濘泞
濟	濟济
濤	濤涛
濫	濫滥
濱	濱滨
濺	濺溅
濾	濾滤
瀉	瀉泻
瀑	瀑
瀕	瀕濒
瀝	瀝沥
瀾	瀾澜
灌	灌
灑	灑洒
灕	灕漓
灘	灘滩
灣	灣湾
火	火
灰	灰
灸	灸
灼	灼
灾	災灾
炊	炊
炎	炎
炒	炒
炕	炕
炫	炫
炬	炬
炭	炭
炮	炮
炸	炸
烈	烈
烏	烏乌
烘	烘
烙	烙
烟	煙烟
烤	烤
烹	烹
焊	焊
焕	煥焕
焙	焙
焚	焚
無	無无
焦	焦
焰	焰燄
然	然
煉	煉炼鍊
煌	煌
煎	煎
煞	煞
煤	煤
照	照
煩	煩烦
煮	煮
熄	熄
熊	熊
熏	熏燻
熒	熒荧
熔	熔鎔镕
熙	熙
熟	熟
熬	熬
熱	熱热
燃	燃
燈	燈灯
燎	燎
燒	燒烧
燕	燕
燙	燙烫
營	營营
燥	燥
燦	燦灿
燭	燭烛
爆	爆
爍	爍烁
爐	爐炉
爛	爛烂
爪	爪
爬	爬
爲	爲为為
爵	爵
父	父
爸	爸
爹	爹
爺	爺爷
爽	爽
爾	爾尔
片	片
版	版
牌	牌
牘	牘牍
牙	牙
牛	牛
牡	牡
牢	牢
牧	牧
物	物
牲	牲
特	特
牽	牽牵
犀	犀
犁	犁
犧	犧牺
犬	犬
犯	犯
狀	狀状
狂	狂
狐	狐
狗	狗
狠	狠
狡	狡
狰	猙狰
狸	狸貍
狹	狹狭
狼	狼
狽	狽狈
猖	猖
猛	猛
猜	猜
猩	猩
猪	豬猪
猫	貓猫
猬	蝟猬
猴	猴
猶	猶犹
猾	猾
猿	猿
獄	獄狱
獅	獅狮
獨	獨独
獰	獰狞
獲	獲获
獵	獵猎
獸	獸兽
獻	獻献
玄	玄
率	率
玉	玉
王	王
玖	玖
玩	玩
玫	玫
玲	玲
玷	玷
玻	玻
珊	珊
珍	珍
珠	珠
班	班
現	現现
球	球
琅	琅瑯
理	理
琉	琉
琢	琢
琳	琳
琴	琴
瑞	瑞
瑟	瑟
瑣	瑣琐
瑩	瑩莹
瑪	瑪玛
瑰	瑰
璃	璃琍
璧	璧
環	環环
瓊	瓊琼
瓜	瓜
瓢	瓢
瓣	瓣
瓤	瓤
瓦	瓦
瓮	甕瓮
瓶	瓶
瓷	瓷
甘	甘
甚	甚
甜	甜
生	生
産	產产産
甥	甥
用	用
甩	甩
甫	甫
田	田
由	由
甲	甲
申	申
男	男
甸	甸
界	界
畏	畏
畔	畔
留	留
畜	畜
畝	畝亩
畢	畢毕
略	略
畦	畦
番	番
畫	畫画
當	當当
畸	畸
疆	疆
疇	疇畴
疏	疏
疑	疑
疙	疙
疚	疚
疤	疤
疫	疫
疲	疲
疹	疹
疼	疼
疾	疾
病	病
症	症
痊	痊
痕	痕
痘	痘
痛	痛
痢	痢
痪	瘓痪
痰	痰
痴	癡痴
痹	痹痺
瘋	瘋疯
瘟	瘟
瘡	瘡疮
瘤	瘤
瘦	瘦
瘧	瘧疟
瘩	瘩
瘸	瘸
療	療疗
癌	癌
癟	癟瘪
癢	癢痒
癩	癩癞
癬	癬癣
癮	癮瘾
癱	癱瘫
登	登
發	發发
白	白
百	百
皂	皂
的	的
皆	皆
皇	皇
皮	皮
皺	皺皱
皿	皿
盅	盅
盆	盆
盈	盈
益	益
盒	盒
盔	盔
盗	盜盗
盛	盛
盞	盞盏
盟	盟
盡	盡尽
監	監监
盤	盤盘
盧	盧卢
目	目
盯	盯
盲	盲
直	直
相	相
盹	盹
盼	盼
盾	盾
省	省
眉	眉
看	看
真	真
眠	眠
眨	眨
眯	眯瞇
眶	眶
眷	眷
眼	眼
着	着
睁	睜睁
睛	睛
睡	睡
督	督
睦	睦
睬	睬
睹	睹
瞄	瞄
瞎	瞎
瞞	瞞瞒
瞧	瞧
瞪	瞪
瞬	瞬
瞭	瞭
瞳	瞳
瞻	瞻
矗	矗
矛	矛
矢	矢
知	知
矩	矩
短	短
矮	矮
矯	矯矫
石	石
砂	砂
砌	砌
砍	砍
研	研
砰	砰
破	破
砸	砸
硅	硅
硝	硝
硫	硫
硬	硬
确	确
硯	硯砚
硼	硼
碉	碉
碌	碌
碎	碎
碑	碑
碗	碗
碘	碘
碟	碟
碧	碧
碩	碩硕
碰	碰踫
碱	碱
碳	碳
碴	碴
碼	碼码
碾	碾
磁	磁
磅	磅
磕	磕
磚	磚砖
磨	磨
磷	磷燐
磺	磺
礁	礁
礎	礎础
礙	礙碍
礦	礦矿
礫	礫砾
礬	礬矾
示	示
社	社
祈	祈
祖	祖
祝	祝
神	神
祟	祟
祠	祠
祥	祥
票	票
祭	祭
禀	稟禀
禁	禁
禍	禍祸
福	福
禮	禮礼
禱	禱祷
禽	禽
禾	禾
秀	秀
私	私
秃	禿秃
秆	稈秆
秉	秉
秋	秋
种	种
科	科
秒	秒
秕	秕
秘	祕秘
租	租
秤	秤
秦	秦
秧	秧
秩	秩
秫	秫
秸	秸
移	移
稀	稀
程	程
稍	稍
税	稅税
稚	稚
稠	稠
稱	稱称
稻	稻
稼	稼
稽	稽
稿	稿
穆	穆
積	積积
穎	穎颖
穗	穗
穢	穢秽
穩	穩稳
穴	穴
究	究
空	空
穿	穿
突	突
窄	窄
窑	窯窑
窒	窒
窖	窖
窗	窗
窘	窘
窟	窟
窩	窩窝
窪	窪洼
窮	窮穷
窺	窺窥
窿	窿
竄	竄窜
竅	竅窍
竈	竈灶
竊	竊窃
立	立
站	站
竟	竟
章	章
竣	竣
童	童
竪	豎竖竪
竭	竭
端	端
競	競竞
竹	竹
竿	竿
笆	笆
笋	筍笋
笑	笑
笙	笙
笛	笛
笤	笤
符	符
笨	笨
第	第
筆	筆笔
等	等
筋	筋
筏	筏
筐	筐
筑	筑
筒	筒
答	答
策	策
筝	箏筝
筷	筷
箍	箍
箕	箕
算	算
管	管
箭	箭
箱	箱
節	節节
篇	篇
篙	篙
篡	篡
篩	篩筛
篷	篷
簇	簇
簍	簍篓
簡	簡简
簫	簫箫
簸	簸
簽	簽签
簿	簿
籃	籃篮
籌	籌筹
籍	籍
籠	籠笼
籬	籬篱
籮	籮箩
米	米
籽	籽
粉	粉
粒	粒
粗	粗
粘	粘
粟	粟
粤	粵粤
粥	粥
粱	粱
粹	粹
精	精
糊	糊
糕	糕
糖	糖
糙	糙
糜	糜
糞	糞粪
糟	糟
糠	糠
糧	糧粮
糯	糯
系	系
糾	糾纠
紀	紀纪
約	約约
紅	紅红
紉	紉纫
紊	紊
紋	紋纹
納	納纳
紐	紐纽
純	純纯
紗	紗纱
紙	紙纸
級	級级
紛	紛纷
素	素
紡	紡纺
索	索
紫	紫
累	累
細	細细
紳	紳绅
紹	紹绍
終	終终
組	組组
絆	絆绊
結	結结
絞	絞绞
絡	絡络
給	給给
絨	絨绒
絮	絮
統	統统
絲	絲丝
絶	絕绝絶
絹	絹绢
綁	綁绑
綉	繡绣綉
經	經经
綜	綜综
綢	綢绸
綫	綫線线缐
維	維维
綱	綱纲
網	網网
綳	綳繃绷
綴	綴缀
綻	綻绽
綽	綽绰
綿	綿绵
緊	緊紧
緑	綠绿緑
緒	緒绪
緞	緞缎
締	締缔
緣	緣缘
編	編编
緩	緩缓
緬	緬缅
緯	緯纬
練	練练
縛	縛缚
縣	縣县
縫	縫缝
縮	縮缩
縱	縱纵
縷	縷缕
總	總总
績	績绩
繁	繁
織	織织
繚	繚缭
繞	繞绕
繩	繩绳
繪	繪绘
繭	繭茧
繮	繮缰韁
繳	繳缴
繹	繹绎
繼	繼继
繽	繽缤
續	續续
纏	纏缠
纓	纓缨
纖	纖纤
纜	纜缆
缸	缸
缺	缺
罐	罐
罕	罕
罩	罩
罪	罪
置	置
罰	罰罚
署	署
罷	罷罢
羅	羅罗
羊	羊
美	美
羔	羔
羞	羞
羡	羨羡
群	羣群
義	義义
羹	羹
羽	羽
翁	翁
翅	翅
翎	翎
習	習习
翔	翔
翠	翠
翩	翩
翰	翰
翹	翹翘
翻	翻
翼	翼
耀	耀
老	老
考	考
者	者
而	而
耍	耍
耐	耐
耕	耕
耗	耗
耘	耘
耙	耙
耳	耳
耻	恥耻
耽	耽
耿	耿
聊	聊
聖	聖圣
聘	聘
聚	聚
聞	聞闻
聯	聯联
聰	聰聪
聲	聲声
聳	聳耸
聶	聶聂
職	職职
聽	聽听
聾	聾聋
肄	肄
肅	肅肃
肆	肆
肉	肉
肋	肋
肌	肌
肖	肖
肘	肘
肚	肚
肛	肛
肝	肝
股	股
肢	肢
肥	肥
肩	肩
肪	肪
肯	肯
育	育
肴	餚肴
肺	肺
胃	胃
背	背
胎	胎
胖	胖
胚	胚
胞	胞
胡	胡
胯	胯
胰	胰
胳	胳
胸	胸
能	能
脂	脂
脅	脅胁
脆	脆
脉	脈脉
脊	脊
脖	脖
脚	腳脚
脯	脯
脱	脫脱
脹	脹胀
脾	脾
腊	腊
腋	腋
腌	腌醃
腎	腎肾
腐	腐
腔	腔
腕	腕
腥	腥
腦	腦脑
腫	腫肿
腮	腮
腰	腰
腸	腸肠
腹	腹
腺	腺
腿	腿
膀	膀
膊	膊
膏	膏
膘	膘
膚	膚肤
膛	膛
膜	膜
膝	膝
膠	膠胶
膨	膨
膩	膩腻
膳	膳
膽	膽胆
膿	膿脓
臀	臀
臂	臂
臉	臉脸
臊	臊
臍	臍脐
臟	臟脏
臣	臣
臨	臨临
自	自
臭	臭
至	至
致	致
臼	臼
舀	舀
舅	舅
與	與与
興	興兴
舉	舉举
舊	舊旧
舌	舌
舍	舍
舒	舒
舔	舔
舞	舞
舟	舟
航	航
般	般
舵	舵
舶	舶
舷	舷
船	船
艇	艇
艘	艘
艙	艙舱
艦	艦舰
良	良
艱	艱艰
色	色
艷	艷艳豔
艾	艾
芋	芋
芍	芍
芒	芒
芙	芙
芝	芝
芥	芥
芬	芬
芭	芭
芯	芯
花	花
芳	芳
芹	芹
芽	芽
苔	苔
苗	苗
苛	苛
苞	苞
苟	苟
若	若
苦	苦
苫	苫
英	英
苹	苹
茁	茁
茂	茂
范	范
茄	茄
茅	茅
茉	茉
茫	茫
茬	茬
茴	茴
茵	茵
茶	茶
茸	茸
荆	荊荆
草	草
荐	荐
荒	荒
荔	荔
荷	荷
荸	荸
莉	莉
莊	莊庄
莖	莖茎
莢	莢荚
莫	莫
莽	莽
菇	菇
菊	菊
菌	菌
菜	菜
菠	菠
菩	菩
華	華华
菱	菱
菲	菲
萄	萄
萊	萊莱
萌	萌
萍	萍
萎	萎
落	落
著	著
葛	葛
葡	葡
董	董
葦	葦苇
葫	葫
葬	葬
葯	葯药
葱	蔥葱
葵	葵
葷	葷荤
蒂	蒂
蒙	蒙
蒜	蒜
蒲	蒲
蒸	蒸
蒼	蒼苍
蒿	蒿
蓄	蓄
蓉	蓉
蓋	蓋盖
蓖	蓖
蓬	蓬
蓮	蓮莲
蔑	蔑
蔓	蔓
蔗	蔗
蔚	蔚
蔣	蔣蒋
蔫	蔫
蔬	蔬
蔽	蔽
蕉	蕉
蕊	蕊
蕎	蕎荞
蕩	蕩荡盪
蕪	蕪芜
蕭	蕭萧
蕾	蕾
薄	薄
薇	薇
薛	薛
薩	薩萨
薪	薪
薯	薯
薺	薺荠
藍	藍蓝
藏	藏
藐	藐
藕	藕
藝	藝艺
藤	藤籐
藴	蘊蕴藴
藹	藹蔼
藻	藻
蘆	蘆芦
蘇	蘇苏甦
蘑	蘑
蘭	蘭兰
蘸	蘸
蘿	蘿萝
虎	虎
虐	虐
處	處处
虚	虛虚
虜	虜虏
號	號号
虧	虧亏
虱	蝨虱
虹	虹
蚊	蚊
蚌	蚌
蚓	蚓
蚜	蚜
蚣	蚣
蚤	蚤
蚪	蚪
蚯	蚯
蛀	蛀
蛆	蛆
蛇	蛇
蛉	蛉
蛋	蛋
蛔	蛔
蛙	蛙
蛛	蛛
蛤	蛤
蛹	蛹
蛾	蛾
蜀	蜀
蜂	蜂
蜈	蜈
蜒	蜒
蜓	蜓
蜕	蛻蜕
蜘	蜘
蜜	蜜
蜡	蜡
蜻	蜻
蝌	蝌
蝎	蝎蠍
蝕	蝕蚀
蝗	蝗
蝙	蝙
蝠	蝠
蝦	蝦虾
蝴	蝴
蝶	蝶
蝸	蝸蜗
螃	螃
融	融
螞	螞蚂
螟	螟
螢	螢萤
螺	螺
蟀	蟀
蟆	蟆
蟋	蟋
蟬	蟬蝉
蟲	蟲虫
蟹	蟹
蟻	蟻蚁
蠅	蠅蝇
蠕	蠕
蠢	蠢
蠶	蠶蚕
蠻	蠻蛮
血	血
衆	衆众眾
行	行
衍	衍
街	街
衙	衙
衛	衛卫
衡	衡
衣	衣
表	表
衩	衩
衫	衫
衰	衰
衷	衷
袁	袁
袋	袋
袍	袍
袒	袒
袖	袖
被	被
袱	袱
裁	裁
裂	裂
裕	裕
裙	裙
補	補补
裝	裝装
裳	裳
裸	裸
裹	裹
褂	褂
褐	褐
褒	褒
褥	褥
褪	褪
褲	褲裤
襖	襖袄
襟	襟
襠	襠裆
襪	襪袜
襯	襯衬
襲	襲袭
西	西
要	要
覆	覆
見	見见
規	規规
覓	覓觅
視	視视
親	親亲
覺	覺觉
覽	覽览
觀	觀观
角	角
解	解
觸	觸触
言	言
訂	訂订
計	計计
訊	訊讯
討	討讨
訓	訓训
記	記记
訛	訛讹
訝	訝讶
訟	訟讼
訣	訣诀
訪	訪访
設	設设
許	許许
訴	訴诉
診	診诊
詐	詐诈
評	評评
詛	詛诅
詞	詞词
詢	詢询
試	試试
詩	詩诗
詭	詭诡
話	話话
該	該该
詳	詳详
認	認认
誓	誓
誕	誕诞
誘	誘诱
語	語语
誠	誠诚
誡	誡诫
誣	誣诬
誤	誤误
誦	誦诵
誨	誨诲
説	說说説
誰	誰谁
課	課课
誹	誹诽
誼	誼谊
調	調调
諄	諄谆
談	談谈
請	請请
諒	諒谅
論	論论
諜	諜谍
諧	諧谐
諱	諱讳
諷	諷讽
諸	諸诸
諺	諺谚
諾	諾诺
謀	謀谋
謁	謁谒
謂	謂谓
謄	謄誊
謊	謊谎
謎	謎谜
謗	謗谤
謙	謙谦
講	講讲
謝	謝谢
謡	謠谣謡
謬	謬谬
謹	謹谨
證	證证証
譏	譏讥
識	識识
譚	譚谭
譜	譜谱
警	警
譬	譬
譯	譯译
議	議议
譴	譴谴
護	護护
譽	譽誉
讀	讀读
變	變变
讓	讓让
谷	谷
豁	豁
豆	豆
豈	豈岂
豌	豌
象	象
豪	豪
豫	豫
豹	豹
豺	豺
貌	貌
貝	貝贝
貞	貞贞
負	負负
財	財财
貢	貢贡
貧	貧贫
貨	貨货
販	販贩
貪	貪贪
貫	貫贯
責	責责
貯	貯贮
貳	貳贰
貴	貴贵
貶	貶贬
買	買买
貸	貸贷
費	費费
貼	貼贴
貿	貿贸
賀	賀贺
賂	賂赂
賃	賃赁
賄	賄贿
資	資资
賈	賈贾
賊	賊贼
賒	賒赊
賓	賓宾
賜	賜赐
賞	賞赏
賠	賠赔
賢	賢贤
賣	賣卖
賤	賤贱
賦	賦赋
質	質质
賬	賬账
賭	賭赌
賴	賴赖
賺	賺赚
購	購购
賽	賽赛
贅	贅赘
贈	贈赠
贊	贊赞讚
贍	贍赡
贏	贏赢
贖	贖赎
贜	贓赃贜
赤	赤
赦	赦
赫	赫
走	走
赴	赴
起	起
趁	趁
超	超
越	越
趕	趕赶
趙	趙赵
趟	趟
趣	趣
趨	趨趋
足	足
趴	趴
趾	趾
跋	跋
跌	跌
跑	跑
跛	跛
距	距
跟	跟
跨	跨
跪	跪
路	路
跳	跳
跺	跺
踏	踏
踐	踐践
踢	踢
踩	踩
踪	蹤踪
踱	踱
踴	踴踊
蹂	蹂
蹄	蹄
蹈	蹈
蹋	蹋
蹦	蹦
蹬	蹬
蹭	蹭
蹲	蹲
蹺	蹺跷
躁	躁
躍	躍跃
躪	躪躏
身	身
躬	躬
躲	躲
躺	躺
軀	軀躯
車	車车
軋	軋轧
軌	軌轨
軍	軍军
軒	軒轩
軟	軟软
軸	軸轴
較	較较
載	載载
輔	輔辅
輕	輕轻
輛	輛辆
輝	輝辉
輩	輩辈
輪	輪轮
輯	輯辑
輸	輸输
輻	輻辐
輿	輿舆
轄	轄辖
轅	轅辕
轉	轉转
轍	轍辙
轎	轎轿
轟	轟轰
辛	辛
辜	辜
辟	辟
辣	辣
辦	辦办
辨	辨
辭	辭辞
辮	辮辫
辯	辯辩
辰	辰
辱	辱
農	農农
迂	迂
迄	迄
迅	迅
迎	迎
近	近
返	返
迫	迫
述	述
迷	迷
迹	跡迹蹟
追	追
退	退
送	送
逃	逃
逆	逆
透	透
逐	逐
途	途
逗	逗
這	這这
通	通
逛	逛
逝	逝
逞	逞
速	速
造	造
逢	逢
連	連连
逮	逮
進	進进
逸	逸
逼	逼
逾	逾
遂	遂
遇	遇
運	運运
遍	遍
過	過过
遏	遏
道	道
達	達达躂跶
違	違违
遜	遜逊
遞	遞递
遠	遠远
遣	遣
遥	遙遥
適	適适
遭	遭
遮	遮
遲	遲迟
遵	遵
遷	遷迁
選	選选
遺	遺遗
遼	遼辽
避	避
邀	邀
邁	邁迈
還	還还
邊	邊边
邏	邏逻
邑	邑
邢	邢
那	那
邦	邦
邪	邪
郁	郁
郊	郊
郎	郎
部	部
郭	郭
郵	郵邮
都	都
鄉	鄉乡
鄙	鄙
鄧	鄧邓
鄭	鄭郑
鄰	鄰邻
酌	酌
配	配
酒	酒
酗	酗
酣	酣
酥	酥
酪	酪
酬	酬
酵	酵
酷	酷
酸	酸
醇	醇
醉	醉
醋	醋
醒	醒
醖	醞酝醖
醫	醫医
醬	醬酱
釀	釀酿
釁	釁衅
采	采採
釋	釋释
里	里
重	重
野	野
量	量
金	金
釘	釘钉
針	針针
釣	釣钓
鈉	鈉钠
鈍	鈍钝
鈎	鉤钩鈎
鈔	鈔钞
鈕	鈕钮
鈞	鈞钧
鈣	鈣钙
鈴	鈴铃
鉀	鉀钾
鉗	鉗钳
鉚	鉚铆
鉛	鉛铅
銀	銀银
銅	銅铜
銑	銑铣
銘	銘铭
銜	銜啣衔
銬	銬铐
銷	銷销
銹	鏽锈銹
銼	銼锉
鋁	鋁铝
鋅	鋅锌
鋒	鋒锋
鋤	鋤锄
鋪	鋪铺
鋭	銳锐鋭
鋸	鋸锯
鋼	鋼钢
錐	錐锥
錘	錘锤
錠	錠锭
錢	錢钱
錦	錦锦
錨	錨锚
錫	錫锡
錯	錯错
録	錄录録
錳	錳锰
鍁	鍁锨
鍋	鍋锅
鍍	鍍镀
鍘	鍘铡
鍛	鍛锻
鍬	鍬锹
鍵	鍵键
鎖	鎖锁
鎬	鎬镐
鎮	鎮镇
鏈	鏈链
鏟	鏟剷铲
鏡	鏡镜
鐐	鐐镣
鐘	鐘钟
鐮	鐮镰
鐵	鐵铁
鐺	鐺铛
鑄	鑄铸
鑒	鑒鉴鑑鍳
鑰	鑰钥
鑲	鑲镶
鑷	鑷镊
鑼	鑼锣
鑽	鑽钻
鑿	鑿凿
長	長长
門	門门
閃	閃闪
閉	閉闭
開	開开
閏	閏闰
閑	閑闲閒
間	間间
閘	閘闸
閣	閣阁
閥	閥阀
閨	閨闺
閩	閩闽
閲	閱阅閲
閻	閻阎
闊	闊阔
闖	闖闯
關	關关
闡	闡阐
阱	阱
防	防
阻	阻
阿	阿
附	附
陋	陋
陌	陌
降	降
限	限
陝	陝陕
陡	陡
院	院
陣	陣阵
除	除
陪	陪
陰	陰阴
陳	陳陈
陵	陵
陶	陶
陷	陷
陸	陸陆
陽	陽阳
隅	隅
隆	隆
隊	隊队
階	階阶
隔	隔
隕	隕陨
隘	隘
隙	隙
際	際际
障	障
隧	隧
隨	隨随
險	險险
隱	隱隐
隸	隸隶隷
雀	雀
雁	雁
雄	雄
雅	雅
集	集
雇	僱雇
雌	雌
雕	雕彫鵰
雖	雖虽
雙	雙双
雛	雛雏
雜	雜杂
離	離离
難	難难
雨	雨
雪	雪
零	零
雷	雷
雹	雹
電	電电
需	需
震	震
霉	霉
霍	霍
霎	霎
霜	霜
霞	霞
霧	霧雾
露	露
霸	霸
霹	霹
靂	靂雳
靈	靈灵
青	青
靖	靖
静	靜静
非	非
靠	靠
靡	靡
面	面
革	革
靴	靴
靶	靶
鞋	鞋
鞍	鞍
鞏	鞏巩
鞠	鞠
鞭	鞭
韌	韌韧
韓	韓韩
韭	韭
音	音
韵	韻韵
響	響响
頁	頁页
頂	頂顶
頃	頃顷
項	項项
順	順顺
須	須须
頌	頌颂
預	預预
頑	頑顽
頒	頒颁
頓	頓顿
頗	頗颇
領	領领
頭	頭头
頰	頰颊
頸	頸颈
頻	頻频
頽	頹颓頽
顆	顆颗
題	題题
額	額额
顔	顏颜顔
顛	顛颠
類	類类
顧	顧顾
顫	顫颤
顯	顯显
顱	顱颅
風	風风
颯	颯飒
飄	飄飘
飛	飛飞
食	食
飢	飢饥
飯	飯饭
飲	飲饮
飼	飼饲
飽	飽饱
飾	飾饰
餃	餃饺
餅	餅饼
養	養养
餌	餌饵
餐	餐
餒	餒馁
餓	餓饿
餡	餡馅
館	館馆
餾	餾馏
饃	饃馍
饅	饅馒
饒	饒饶
饞	饞馋
首	首
香	香
馬	馬马
馮	馮冯
馱	馱驮
馳	馳驰
馴	馴驯
駁	駁驳
駐	駐驻
駒	駒驹
駕	駕驾
駛	駛驶
駝	駝驼
駡	罵骂駡
駭	駭骇
駱	駱骆
駿	駿骏
騎	騎骑
騙	騙骗
騰	騰腾
騷	騷骚
騾	騾骡
驅	驅驱
驕	驕骄
驗	驗验
驚	驚惊
驟	驟骤
驢	驢驴
骨	骨
骯	骯肮
髓	髓
體	體体
高	高
鬢	鬢鬓
鬧	鬧闹
鬼	鬼
魁	魁
魂	魂
魄	魄
魏	魏
魔	魔
魚	魚鱼
魯	魯鲁
鮮	鮮鲜
鯉	鯉鲤
鯨	鯨鲸
鯽	鯽鲫
鰐	鰐鳄鱷
鰭	鰭鳍
鱉	鱉鳖
鱗	鱗鳞
鳥	鳥鸟
鳩	鳩鸠
鳧	鳬凫鳧
鳳	鳳凤
鳴	鳴鸣
鴉	鴉鸦
鴕	鴕鸵
鴛	鴛鸳
鴦	鴦鸯
鴨	鴨鸭
鴻	鴻鸿
鴿	鴿鸽
鵑	鵑鹃
鵝	鵝鹅
鵡	鵡鹉
鵬	鵬鹏
鵲	鵲鹊
鶯	鶯莺
鶴	鶴鹤
鷄	鷄鸡雞
鷗	鷗鸥
鷹	鷹鹰
鸚	鸚鹦
鹵	鹵卤
鹽	鹽盐
鹿	鹿
麗	麗丽
麥	麥麦
麩	麩麸
麻	麻痲
黄	黃黄
黍	黍
黎	黎
黑	黑
黔	黔
默	默
點	點点
鼎	鼎
鼓	鼓
鼠	鼠
鼻	鼻
齊	齊齐
齋	齋斋
齒	齒齿
齡	齡龄
龍	龍龙
龐	龐庞厖
龜	龜龟