§ 基本笔画
一	横
丨	竖
丿	撇
丶	点
㇀	提
㇂	斜/斜钩
〇	圈	顺时针，用于连接

§ 上下结构之上（先于连接结构书写）
丰	横横横竖
干	横横竖
㐄	横横竖
丅	横竖
蛋字头	横竖横竖折
十	横竖
⺊	横竖
士/土	横竖横
立	横竖横横
𫜹	横竖圈
共字头	横点撇
平字头	横点点竖	简化作「干」「乐字头」
夹字头	横点点竖
尧字头	横斜撇
乛	横折/横弯
龴	横折点
刀	横折钩竖
夬字头	横弯竖/横弯竖
肀	横弯点竖
中	竖横弯竖	简化作「⿻丷丨」，弱起笔
巾	竖横弯竖
日/田/罒/目	竖横弯圈	简化作「勹」「⺈」
⺌	竖点撇
𠂉	撇横
午字头	撇横竖
千	撇横竖
牛字头	撇横竖
长字头	撇横竖
⺈	撇横折
夂	撇横折圈点/撇横折圈横	简化作「为字头」
亻	撇竖/撇弯
犬字头	撇竖/撇圈竖
乎字头	撇点点竖	简化作「千」
亠	点横	简化作「𠂉」
丷	点撇
䒑	点撇横	即「⿱丷一」
米字头	点撇横竖
半字头	点撇竖
前字头	横（下）横折

§ 上下结构之中
⺈（闪电形）	撇横撇/撇点撇
亻	撇竖/撇弯
丷	点撇	此先于连接结构书写，而后写者记作「⿻*八」

§ 上下结构之下
朩	横竖钩点点
子字底	横撇竖圈弯	即「一」结合「禸字底」，常出现在走之旁之上
又	横撇点/横撇圈点
之字底	横折点/撇横折点	简化作「⺀」「乙」
乙	横折弯钩	简化作「之字底」
龴	横弯点
万字底	横弯钩撇
丄	竖横
㐄	竖横横/竖钩横横
龶	竖横横横（上连竖）/横竖圈横（上连其它）	简化作「土」
丰	竖横横横
升字底	竖横竖/竖圈横竖
木	竖横撇点	简化作「㐄」，此上接竖，而上接其它时常作「朩」
开字底	竖竖横/竖圈横竖
丹字框	竖竖横
㇄	竖弯
亅	竖钩
十	竖钩横	简化作「才字底」
氺	竖点点撇点
介字底	竖钩撇点
来字底	竖钩撇折撇点	由「⺈」与「介字底」连写
才字底	竖钩点
艮字底	竖钩点	简化作「厶」
小	竖钩点点
𠄌	竖提
土	竖圈横（上接竖）
禸字底	竖圈弯
少	竖圈撇
夫字底	撇横撇点	简化作「之字底」，也可作「大」「⿱⺈八」
勹	撇横弯钩
儿	撇竖弯钩
豕字底	撇竖弯钩撇竖提撇点	简化作「氺」
𧘇	撇竖钩点
人	撇点
㐅	撇点
厶	撇折点/撇折弯/竖折点/竖折弯	在左下侧简化作「𠄌」
美字底	撇圈点点
八	点点
⺀	点点	在左下作「二」
三点底	点点点
走之底	斜横

§ 左右结构之左
木	竖横提
丩	竖（右）竖提
夕	撇横弯圈

§ 左右结构之右
丄	竖横/撇横	省略用符号
々	撇竖弯点

§ 其它基本部件
二	横横
七	横竖弯钩
厂	横撇
大	横撇点
㇕	横弯
𠃌	横折钩/横弯钩
窄弯钩	横弯钩
力	横弯钩撇
㇈	横折弯钩
口	竖横弯横	简化作「两笔口」「八」「龴」，在上侧简化作「乛」「龴」「厶」，在下侧简化作「两笔口」「㇕」「八」，在上下之中简化作「一」，在左下侧简化作「夕」，在左右之中简化作「〇」，在包围之中简化作「八」「〇」「一」
冂	竖横弯竖钩
日/目	竖横弯钩横/竖横弯圈	简化作「口」
乍字形	竖弯钩丿丿
两笔口	竖横弯
甲申由	竖横弯横竖
井	竖竖横横
女	竖竖弯弯
⺆	竖撇横弯竖钩
乚	竖弯钩
⺈	撇横撇/撇横弯撇
々	撇竖弯点
𠤎	撇竖弯钩
人	撇点	在上侧简化作「𠂉」，在右侧简化作「丄」
𠂇	撇圈横
倒插点	点	记作「⿻*丶」
广	点横撇
为字头	点撇圈横/横撇圈横

§ 常见组合部件
𤴓	⿱一龰
龰	乙/[之字底]
弔	⿱丅巾/⿻弓丨
工字框	⿱丅丄
工人形	⿰工丄	省略用
王	⿱丅土
龶	⿱十土
斜十字	⿱十㇂
发字头	⿻一[为字头]
龷	⿱[共字头]一
卅	⿻一𭕄
刀	⿹𠃌丿
己	⿱𠃌乚
朵字头	⿱乛㇄
㇎	⿱乛㇕
串字形	⿻弓丨/⿻㇡丨
㇡	⿱乛勹
乃点	⿹㇡丶
乃一	⿹㇡一
乃圈	⿹㇡〇
乃叉	⿹㇡㐅
乃口	⿹㇡口
子	⿱乛十
㇉	⿱丨勹
且	⿱⿰丨㇎一
旧	⿰丨日	简化作「⿲丶丶㇕」或「𭕄」
匕	⿺乚丶/⿻乚丶
包一	⿹勹一
勺	⿹勹丶
包圈	⿹勹〇
包叉	⿹勹㐅
句	⿹勹[两笔口]
冖	⿰丶㇕
𭕄	⿰丶丷
三点门	⿰丶冖

§ 常见组合化简
乐字头	⿳丅丿十	由「⿳一田*」「⿳一日*」简化
车字头	⿳十丿十	由「⿳十田*」「⿳十日*」简化，简化作「⿳十丷*」
柬字头	⿳十丿⿰㇕十
大	⿱十八	由「⿳*田八」「⿳*日八」简化
虎字底	⿻⿹𠃌㇕丨	由「㇕」「冖」「𠃌」结合「中」「巾」简化

§ 其它部件
戈	横斜钩撇点
也	横弯竖斜
山	竖提竖提弯
止	⿺乚⿰丶丶
斤	撇竖撇横弯